Water: H₂O
Carbon Dioxide: CO₂
Methane: CH₄
Ethanol: C₂H₅OH
Glucose: C₆H₁₂O₆
Oxygen: O₂
Ammonia: NH₃
Sulfuric Acid: H₂SO₄
Sodium Chloride: NaCl
Acetic Acid: CH₃COOH
Calcium Carbonate: CaCO₃
Nitrogen: N₂
Acetone: C₃H₆O
Propane: C₃H₈
Butane: C₄H₁₀
Hydrogen Peroxide: H₂O₂
Sodium Bicarbonate: NaHCO₃
Benzene: C₆H₆
Toluene: C₇H₈
Chloroform: CHCl₃
Acetonitrile: C₂H₃N
Glutamic Acid: C₅H₉NO₄
Magnesium Sulfate: MgSO₄
Phosphoric Acid: H₃PO₄
Ethylene: C₂H₄
Acetylene: C₂H₂
Formaldehyde: CH₂O
Isopropanol: C₃H₈O
Citric Acid: C₆H₈O₇
Ascorbic Acid: C₆H₈O₆
Sodium Hydroxide: NaOH
Potassium Chloride: KCl
Calcium Hydroxide: Ca(OH)₂
Boric Acid: H₃BO₃
Oxalic Acid: C₂H₂O₄
Aluminum Oxide: Al₂O₃
Nitric Acid: HNO₃
Hydrogen Cyanide: HCN
Diethyl Ether: C₄H₁₀O
Sodium Phosphate: Na₃PO₄
Urea: CO(NH₂)₂
Methanol: CH₃OH
Isobutane: C₄H₁₀
Naphthalene: C₁₀H₈
Sucrose: C₁₂H₂₂O₁₁
Calcium Sulfate: CaSO₄
Sodium Nitrite: NaNO₂
Phenol: C₆H₆O
Potassium Permanganate: KMnO₄
Magnesium Hydroxide: Mg(OH)₂
Sodium Hypochlorite: NaClO
Carbon Monoxide: CO
Hydrogen Chloride: HCl
Silver Nitrate: AgNO₃
Ethylene Glycol: C₂H₆O₂
Stearic Acid: C₁₈H₃₆O₂
Glycine: C₂H₅NO₂
Potassium Nitrate: KNO₃
Glutathione: C₁₀H₁₇N₃O₆S
Polyethylene: (C₂H₄)n
Trichloroethene: C₂HCl₃
Cyclohexane: C₆H₁₂
Potassium Bromide: KBr
Caffeine: C₈H₁₀N₄O₂
Barium Chloride: BaCl₂
Tartaric Acid: C₄H₆O₆
Iodine: I₂
Bicarbonate: HCO₃⁻
Sodium Fluoride: NaF
Xylene: C₈H₁₀
Histidine: C₆H₉N₃O₂
Bromine: Br₂
Lithium Carbonate: Li₂CO₃
Cysteine: C₃H₇NO₂S
Sodium Benzoate: C₇H₅NaO₂
Lithium Hydroxide: LiOH
Ammonium Chloride: NH₄Cl
Acetylsalicylic Acid: C₉H₈O₄
Aluminum Sulfate: Al₂(SO₄)₃
Sodium Sulfide: Na₂S
Epinephrine: C₉H₁₃NO₃
Chlorine: Cl₂
Sodium Silicate: Na₂SiO₃
Potassium Dichromate: K₂Cr₂O₇
Ethyl Acetate: C₄H₈O₂
Testosterone: C₁₉H₂₈O₂
Hydrochloric Acid: HCl
Silicon Dioxide: SiO₂
Ribose: C₅H₁₀O₅
Lithium Bromide: LiBr
Sodium Thiosulfate: Na₂S₂O₃
Selenium Dioxide: SeO₂
Hydrogen: H₂
Glycerol: C₃H₈O₃
Zinc Oxide: ZnO
Pyridine: C₅H₅N
Triethylamine: C₆H₁₅N
Pyrimidine: C₄H₄N₂
Lauric Acid: C₁₂H₂₄O₂
Hypochlorous Acid: HClO